{
  "snakeStart": {
    "Item1": 4,
    "Item2": 5
  },
  "eaters": [
    {
      "Item1": 45,
      "Item2": 10
    },
    {
      "Item1": 43,
      "Item2": 16
    }
  ],
  "perksTtl": 6,
  "minimumWinLength": 5,
  "exitPoint": {
    "Item1": 49,
    "Item2": 10
  },
  "perksMap": [
    {
      "Item1": "Attack",
      "Item2": 6
    },
    {
      "Item1": "Speed",
      "Item2": 3
    }
  ]
}
@
XXXXXXXXXXXXXXXXXXXXXXXXXXXXXXXXXXXXXXXXXXXXXXXXXX
X                                                X
X                                                X
X                                                X
X            X        XXXXXXX        X           X
X            X      XXX     XXX      X           X
X            X                       X           X
X            X                       X           X
X            X                       X           X
X            X                       X           X
X            XXXXXXXXXXX  XXXXXXXXXXXX           X
X            X                       X           X
X            X                       X           X
X            X                       X           X
X            X      XXX     XXX      X           X
X            X        XXXXXXX        X           X
X                                                X
X                                                X
X                                                X
XXXXXXXXXXXXXXXXXXXXXXXXXXXXXXXXXXXXXXXXXXXXXXXXXX
###
{
  "snakeStart": {
    "Item1": 4,
    "Item2": 5
  },
  "eaters": [
    {
      "Item1": 35,
      "Item2": 16
    },
    {
      "Item1": 33,
      "Item2": 6
    }
  ],
  "perksTtl": 6,
  "minimumWinLength": 15,
  "exitPoint": {
    "Item1": 49,
    "Item2": 10
  },
  "perksMap": [
    {
      "Item1": "Attack",
      "Item2": 10
    },
    {
      "Item1": "Speed",
      "Item2": 6
    }
  ]
}
@
XXXXXXXXXXXXXXXXXXXXXXXXXXXXXXXXXXXXXXXXXXXXXXXXXX
X                                                X
X                                                X
X                 X            X                 X
X                 X            X                 X
X                 X            X                 X
X                 X            X                 X
X                 X            X                 X
X       XXXXXXXXXXX            XXXXXXXXXXXX      X
X                                                X
X                                                X
X       XXXXXXXXXXX            XXXXXXXXXXXX      X
X                 X            X                 X
X                 X            X                 X
X                 X            X                 X
X                 X            X                 X
X                                                X
X                                                X
X                                                X
XXXXXXXXXXXXXXXXXXXXXXXXXXXXXXXXXXXXXXXXXXXXXXXXXX
###
{
  "snakeStart": {
    "Item1": 4,
    "Item2": 5
  },
  "eaters": [
    {
      "Item1": 15,
      "Item2": 10
    },
    {
      "Item1": 23,
      "Item2": 6
    }
  ],
  "perksTtl": 6,
  "minimumWinLength": 15,
  "exitPoint": {
    "Item1": 49,
    "Item2": 17
  },
  "perksMap": [
    {
      "Item1": "Attack",
      "Item2": 15
    },
    {
      "Item1": "Speed",
      "Item2": 7
    }
  ]
}
@
XXXXXXXXXXXXXXXXXXXXXXXXXXXXXXXXXXXXXXXXXXXXXXXXXX
X                                                X
X                                                X
X                 X            X                 X
X                 X            X                 X
X                 X            X                 X
X            XXXXXX            XXXXXX            X
X            X                      X            X
X       XXXXXX       XXXXXXXX       XXXXXXX      X
X                           X                    X
X                           X                    X
X       XXXXXX       XXXXXXXX       XXXXXXX      X
X            X                      X            X
X            XXXXXX            XXXXXX            X
X                 X            X                 X
X                 X            X                 X
X                                                X
X                                                X
X                                                X
XXXXXXXXXXXXXXXXXXXXXXXXXXXXXXXXXXXXXXXXXXXXXXXXXX
###
{
  "snakeStart": {
    "Item1": 4,
    "Item2": 6
  },
  "eaters": [
    {
      "Item1": 15,
      "Item2": 10
    },
    {
      "Item1": 23,
      "Item2": 6
    }
  ],
  "perksTtl": 6,
  "minimumWinLength": 8,
  "exitPoint": {
    "Item1": 49,
    "Item2": 18
  },
  "perksMap": [
    {
      "Item1": "Attack",
      "Item2": 15
    },
    {
      "Item1": "Speed",
      "Item2": 8
    }
  ]
}
@
XXXXXXXXXXXXXXXXXXXXXXXXXXXXXXXXXXXXXXXXXXXXXXXXXX
X                                                X
X    XXXX   X   X  XXXXX   XXXX   X   X  XXXXX   X
X       X   X   X  X   X      X   X   X  X   X   X
X       X   X   X  X   X      X   X   X  X   X   X
X    XXXX   XXXXX  X   X   XXXX   XXXXX  X   X   X
X                                                X
X                                                X
X    XXXX   XXXXX  XXXXX    XXXX   X   X  XXXXX  X
X       X   X   X  X   X       X   X   X  X   X  X
X       X   X   X  X   X       X   X   X  X   X  X
X    XXXX   X   X  X   X    XXXX   XXXXX  X   X  X
X                                                X
X                                                X
X     XXXX   X   X  XXXXX   XXXX   XXXXX  XXXXX  X
X        X   X   X  X   X      X   X   X  X   X  X
X        X   X   X  X   X      X   X   X  X   X  X
X     XXXX   XXXXX  X   X   XXXX   X   X  X   X  X
X                                                X
XXXXXXXXXXXXXXXXXXXXXXXXXXXXXXXXXXXXXXXXXXXXXXXXXX